30-xo
-------------------------------}------------------
--------------------------------------------------
-------------}---------------}----------}---------
------------------}---}---------------------------
-------------}----}---------------------}---------
----}---------------}--}--------------------------
-----}---------}-}--}-----------------------------
------}----------------------------------}--------
-------------------------}--------------}---------
------------------}------------}------------------
--------}--------------------}-------}------}-----
--------------------------------------}-----------
-}----------}-------------------------}-----------
}---}---------------------------------------------
------------------------------}-----------------}-
---------xx----------------}--------}-------}--}--
-------}--------}--------------------------------}
--------------------------------------------------
-}---------------}-----------------------}--------
----------------------------------------------}---
--------------------------------------------------
---------------------------------}---------------}
------------------------}--}-------}-----------}--
---}---}----}-------------------------------------
---}----------------}----------}------------}-----
----}------xx-----}----}--------------------------
----}-------------}------------}------------}-----
-}-----------}-------}----------------------------
---}----------}--}----------------}---------------
-----------------------------------------------}--
